21212121212121212121212121212121212200002021212121212121212121212121212121212121
21212121212121212121212121212121133200002021212121212121212121212121212121212121
21212121212121212121212121212113320001003014212121212121212121212121212121212121
21212121212121212121212121211332030000000230142121212121212121212121212121212121
21211331313131313131313131313202070402010101303131313131313131313131313131142121
21212215161616161616161616161617010101151616161616161616161616161616161617202121
21212225273636363636363636363637010003353636363636363636363636363636362527202121
21212225270101040002000100030301000201010100010102020500000102000200002527202121
21212225270115161617001516161704010001010000020004000201000100030000002527202121
21212225270025262627012526262701000001000101000002000015161616161701012527202121
21212225270235383637003538363700031516161616161702000025262626262701032527202121
21212225270202020107000403040401012526262626262700040125262626262702042527202121
21212225270103001516161616170102002526262626262701000035363839363701032527202121
21212225270602002545464748270007002526262626262701020000000002000002012527202121
2121222527020001353836363837000100353636383a363702040006000000000301012527202121
21212225270001020202000004000001000000000100000100013402013400003401012527202121
21212225270000000200000001000101010001020001000002010000000201020302023537303131
21212225270001010001000100010100010001000001030200040100000000000100000001010300
21212225270401021516161616170101001516161616170200001516161616170001000001000600
21212225270033002526262626270203012526262626270000002526262626270200010301000501
21212225270105002526262626270103012526262626270200032526262626270005000040414141
21212225270234003536382b36370000023536382a36370100013536382936370000014054515151
21212225270002000000010100000400000000000000000401000101000301000600005051515151
21133225270000000200000100010300000102000001010001000100000001000100005051515151
21220135370002000102000101000000000001010001010004000000020201000000405451515151
31320000000601000001030101151616161617000102151616161616170003030040545151515151
00000001000000151616170000252626262627000100252626262626270200010150515151515151
00000015170304252626270600252626262627000101252626262626270000010050515151515151
111112252700013538363703003536381936370101003536381a3636370000010150515151515151
21212225270000020001020002010204000100000102000000020100000100040150515151515151
21212225270101030000040101000601020000030102000000000006000201024054515151515151
21212225270115161617010004000001020000010200020000010000010100015051515151515151
21212225270025262627030100040201000001340000340202330003030001405451515151515151
21212225270135383637020301010002330200000003000000000007404141545151515151515151
21212225270201000100000000010001020102000040414141414141545151515151515151515151
21212225261616161616161617010000044041414154515151515151515151515151515151515151
21212235363636363636363637000000405451515151515151515151515151515151515151515151
21212311111111111111111112020340545151515151515151515151515151515151515151515151
21212121212121212121212122000050515151515151515151515151515151515151515151515151
21212121212121212121212122020050515151515151515151515151515151515151515151515151

image image:village
hero @20,15
home @20,14
shop @28,21 shop:grocery
shop @19,21 shop:pets
shop @10,21 shop:stationery
shop @15,28 shop:hardware
shop @24,28 shop:candy
condensery @29,12
door @19,0 map:2 @10,39 0x0000
door @18,0 map:passage_n @9,39 0x0000
door @39,17 map:3 @0,8 0x0000
door @39,18 map:3 @0,9 0x0000
door @39,19 map:3 @0,10 0x0000
door @13,39 map:4 @8,0 0x0000
door @14,39 map:4 @9,0 0x0000
door @0,26 map:5 @39,8 0x0000
door @0,27 map:5 @39,9 0x0000
door @9,14 map:14 @19,29 0x0000
door @12,14 map:15 @19,29 0x0000
