10111111111112404210111111111111111111111111111111111111111111111111111111111112
20133131313132505230313131313131313131313131313131313131313131313131313131311422
20220101000202505200010000030102010000000000000100020001010002010100010000022022
20220000000201505202010501020001000101060000010102000006000103000201000500012022
20220300000002505342060000040003000100000100000102000101000201000000010300012022
20220001000100505153414142010500010001000001010103000000000000030301020102002022
20220305010200504361614453414141414202000400010000020002020100000002010000042022
20220301000000505200016061616161445203000000010102020002050000000002000100022022
30320003404141545200000203000003505201010000000100000001000001010000020000002022
40414141544361616201000300000100505341414202040000000002000000030000010103012022
60616161616200000000010100000000606161445200020002000202000001010000020002042022
10120000000100020000000202000001010000505200000000040001000100000000000200012022
20220200000200000002040001000002020004606201000000000001050002000400000000012022
20220002000101000001010101000001000100010501020005020101020000000301000001012022
20220203010100000002040000010002020000404200000201000005000100000004000200002022
20220000030001000301010600010100010000505202000000000000000002020202040000002022
20220500000000000200000001000101010000505201000002000000000003020202000001002022
20220100010001000100010002030000000000505200000000030000040002020000010003012022
20220000000004000006030001010101000200505200000300000202000200020001000001022022
20220200020000001011120240414206010501505200030000040100000000000000010100023032
20220101000201102421220350515342010100505200000100000000010000040105010102014042
20220000020510241331320160614453420300505200000000000001000000010100030101015052
20220000000120212200020001015051520101505200000301010301010100000200000200025052
20220000010130313201000100006061620000505200010001000100000001000202000100005052
20220000030000000004010201010101010102505201000001000401010401000001020000005052
20220200010001000015161617021516161700505341420001000202000003030502000200005052
20220034013400330535383a37023538393703606144520101010200000200010000020000005052
30320102050001010000010001030000060002000050520002000001010000010005000300005052
40420133003300340500020001000501151616170150520001000302000000010200030003015052
50520101000000000003000400000300353829370350520201000000000000000100000000005052
50520034023301340201020101020100000200010350520101010203000201000001000200005052
50520500000204000101070502000002151616170050520000000101000100000003000001005052
5052006301640063020100000001020135382a370050520000020000000000000200050200005052
50520000010002040101000100000500020200000050520100010003010000020002000100005052
50520163036400630115161617001516161701404154520001000001000000000400010203005052
505201000200000200353819370235381a3704504361620100010000000001010201030201015052
50520664026300630000000001010003010200505200000000010000000004010200000102005052
50520100000000000000000300000000030003505201000004000000000003000401010104015052
50534141414141414141414141414141414141545341414141414141414141414141414141415452
60616161616161616161616161616161616161616161616161616161616161616161616161616162

image image:village
hero @10,27
sprite @17,11 sprite:item (u8:item)rabbit 0x000000
sprite @2,22 sprite:item (u8:item)cheese 0x000000
sprite @2,21 sprite:item (u8:item)quail 0x000000
sprite @2,20 sprite:item (u8:item)egg 0x000000
sprite @2,19 sprite:item (u8:item)goat 0x000000
sprite @2,18 sprite:item (u8:item)pig 0x000000
sprite @2,17 sprite:item (u8:item)sheep 0x000000
sprite @2,16 sprite:item (u8:item)deer 0x000000
sprite @2,15 sprite:item (u8:item)cow 0x000000
sprite @2,14 sprite:item (u8:item)carrot 0x000000
sprite @2,13 sprite:item (u8:item)potato 0x000000
sprite @2,12 sprite:item (u8:item)cabbage 0x000000
sprite @2,11 sprite:item (u8:item)rat 0x000000
sprite @2,23 sprite:item (u8:item)banana 0x000000
sprite @6,20 sprite:item (u8:item)watermelon 0x000000
sprite @7,19 sprite:item (u8:item)pumpkin 0x000000
sprite @8,18 sprite:item (u8:item)noodles 0x000000
sprite @9,18 sprite:item (u8:item)bread 0x000000
sprite @10,18 sprite:item (u8:item)bouillon 0x000000
sprite @12,18 sprite:item (u8:item)gumdrop 0x000000
sprite @13,18 sprite:item (u8:item)peppermint 0x000000
sprite @14,18 sprite:item (u8:item)licorice 0x000000
sprite @15,19 sprite:item (u8:item)chocolate 0x000000
sprite @16,20 sprite:item (u8:item)butterscotch 0x000000
sprite @6,10 sprite:item (u8:item)buckeye 0x000000
sprite @7,10 sprite:item (u8:item)applepie 0x000000
sprite @8,10 sprite:item (u8:item)birthdaycake 0x000000
sprite @9,7 sprite:item (u8:item)weddingcake 0x000000
sprite @10,7 sprite:item (u8:item)shovel 0x000000
sprite @11,8 sprite:item (u8:item)fishpole 0x000000
sprite @12,8 sprite:item (u8:item)bow 0x000000
sprite @13,8 sprite:item (u8:item)sword 0x000000
sprite @14,8 sprite:item (u8:item)stone 0x000000
sprite @15,8 sprite:item (u8:item)apology 0x000000
sprite @18,11 sprite:item (u8:item)loveletter 0x000000
sprite @16,11 sprite:item (u8:item)trap 0x000000
