34343334333333343333343434343334333333333433333434343333333334333433343334333333
34000001000303000001010200000007040001000100010201000103000000000002000200000034
34000100000100010000020000020000010301020200030001030200000005000000010200000034
33000402000400000002000000010302040000030100000003020202020000020000000000030134
33000101000200000001040000040000000300010000010200060201000100000002000000050134
33020001040000010001000001020001000001020002010105010001000000010000000401030034
34000102000102010000020004010100000004030100030000020500000000000100020100010234
34020501000203000000000000000300020000010102020100000100010401000003000200010033
34000002000000030100020001030000000000000100000000010000000000000001020100010033
34000100000202000101010201000002010000000101020000000201000201000001010100000034
34000502000000000102010000030100010200020000000000020000020101000000000407040033
34040201000001000304000007000100030000010002010001010000010500010001010100010033
34000300030103000003000000000000020200000000010001020200000002010000010001030033
33000001010002000000020000020003030000010103000103000000000104000001000500000033
34000200000304010200000000000000000300010202020004000001000000040401000000000033
33010100060502000000010000000004000000010000000200000400000000000101010004040234
34000002040303010000030100010003010101020502010001010203000101020101000100010133
34010002010000000202000100000103030300000102000101020002000004000000000000000233
34000100010006010200010003030000000000000100000000020101030201000300010200020233
33070100000001000000000000000100010001030001010004000002030000010101000002000033
34010000030000020004010200020200010500000101010000000002000000040000000302000533
33000000000603000101000000000300040001020000000000000102030401010200030001000033
33000100040100000000010001000101010400020000000200030103030000030103000301010033
33020200010103010000010001000000000200010000000101020004010000000000060003000134
33000003000200030004000000000000020000010100000204020001000102010100000000000033
34000002030100010101000101050002010000000001000300000103000100000200000003000033
33000201000002020100000304040002000003000601000000020001000003020000000001030033
34000000000001010001000002060100010204000202010101070001020303000201000004040034
34000100010300020003010100010000030100000102050000000100020100010203000100050033
33000000000000010000040000000100000004040002000000010000000101020100000000040034
34000000020100000301010101020402000002020000000001020000050202000100010002020034
33020002030000010001000000000000000000000000000000000202010200010000000201000033
33020001000100010300000003000000020101020000010100020000020100000600010400010034
33030000010101010300000002010100010000010001000000000000000102000100030001010034
33000000010000000000010001010002020001000200020201010003000500000000000000000033
34000000000000000201010000000001000300000000030101000402030200010000020101000333
00000100040401010100040002000400010300010100030000020000000200000100040102010434
00000202010000020000000001020001000000000001010305020000010000000100010101070133
34020004000000020000020105000100010101000000020201010004000000000100010003010434
34333333343434333334333434343333343434343334333333343433333433343334333333343333

image image:3
door @0,36 map:passage_s @19,36 0x0000
door @0,37 map:passage_s @19,37 0x0000
trappable (u8:item)rabbit 10
trappable (u8:item)quail 10
forage
sprite @14,32 sprite:item (u8:item)brightsauce 0x000000
