34343434343334333334333433343434343334333434343433333334343433333434333433343434
33030002000105000005000001020201010100000000010101000100000005020102000100000233
34010301000200020100010100000401000100010202010004000000000001020200020003030333
34000700000200000101000001010402000105010200020000000000000102020000040103020034
34010203010505010201030400000001020000010000000305020000020001000000010100010233
33010003010000010000000100000001000100010000000003000100000101020003000004000033
34020000000101000100000000050001000100000000000000010100010101010100000000030034
34000000020100000000000000020101000302000201000001000200000100010300010101000233
33020200010001010000010200010300000203000100000200030400010000000100000400020233
34030004000000020100000002000001000000020202000001000001000100020001000100020233
34000001000001000100010101010201020001010004010201000000010002020202010000000134
34030200020300020300010200010000010401030003050000010000010001020004000001000434
33000300000100000000000100020300000000020002000100020001000003000001000201000134
34010001010002020000010101020200000000020100000000000200000303000104010000010134
34000000030102030000000101000000000000010500000205010200000000030403010000010034
33000001000001020100010100010200000001000000010000000106000102060005010000010134
33000000000301000000000002020100010000020101030001020000020400030001000100020033
33010000050003020101000006000000000000020501030102000000010301000102010001000033
34010000020001060000000103000100000000000201010000000200020000000000000004000334
34000000020101000000000002040000000200020100000001020101000302010000010201000033
33010002000001000100000100000200030100070001000001010000010001000201030000020134
33010000010000000102030102020201010002010001000100000002020402020100010000000134
34000100000100000203010000030002000002000001050101020400010003000000040200000033
34000002020006000002020200000103000001010200030001010001000200000002000000000433
33000100010004020203060100000003030001000000040102000101010000000300040003010433
33000206010200000301000000070001000101000200000000010202030300000001000000060034
34000001010100020200000201000000000400010001050300010005020000000100000001020133
34000100000001010102010201020105000100050102000201030203000000000000020104000333
34000100000100050005000100000102070002010400030300000000000100000100010000010034
33010000020200000001020002000000040301000006000001000001000000040003000000010033
34010200010300000100000101010005010203010100040001040100000102000001000200010134
34000100070000010003010100020003000203010000020003000205000201000201000001000033
34000100010101000302010103000300000000060200070200010002000100000000010002030034
34010002000001020001000002000004000401000100000001000100020000010000010201000034
33010201000000010005020100000104000000010002000000000206020005040001020200010205
34010000000101000201000601000101000003020004000005010000000100000401010002000004
34030001000100020001010000010200000401000000010001000202010001000101010600000134
33010101010200010001010001020100030400020200000102000103010200010000020001040034
33000002000001010001000001000200010002000000030100020002010200020000010000010034
34343433343333343433333333333333343434343434343434343434343434343434343433333333

image image:3
door @39,34 map:passage_s @0,34 0x0000
door @39,35 map:passage_s @0,35 0x0000
trappable (u8:item)rat 10
trappable (u8:item)quail 3
forage
sprite @26,29 sprite:item (u8:item)sunsauce 0x000000
