34000034333334333434343334343334333433343433333334333334333434343334333333343434
33010000020004000101000102020000000001010000000000000100050101000000010202000034
34000001000100000000000000010000000003020200040000020000030206000001010000010134
34000003000002000101000101000000010201010000000201000100010000000000040100000033
33000001000000020000000103000101040102000000000000000201010001020200000000000034
34000101010001020000010003010000000000000401020003000302000300000001000000000333
33010102000001010003000000000307000103010000010201000004000106020002000000010333
33000100020101000001070100010100000001010001000101000201000002000200000101000034
33000600030400050002010100010201050104020000000100000000000101060000000100000633
34030100000001010200000402000000000100020002040000000000000002000202020001020134
33020001020001000001030000010101010000030002000006000000000001000300000201000034
34000002000100000002000400000001000000010004000201000105000201010304000001000034
34000001020202000103000000000300000002000100050000000201000100030000000100000034
34000204030400000002020100000101010000010000000103020101040000000104010201010033
34010300000300000104020101000101070103000401000500000300020000000100000005000233
33000000010201010200010200020100020001000000000201000002000005000002000400010233
34020000010002000000010002020100010005010000000001000003000004000300030700010034
33010000010203010100020100040000000000000102010200000000020000000000000001010333
33020100010101000000060102010202010000000000000200000001000200010000000003010133
33000002010001010002000002010102010001000000000101010300010203000200010104010233
34000000030100070100020203000100000304030000010102010100000000000101000101000033
34050101000002020101000001000307000000010102020102000102050100000001010102010033
33000300010100000100010201010300000003030100020001020301000200000101000100010133
33000300000000010001000100000101000003000202010100020101010002020002000100000034
34000000000000010202020000000201000000000201000000010101030000010100020002000034
34000200000301000000000204000001010200020003000106010201030001020006000003010034
33000002020000030302010000000201020004020200000001020000000000010101010303040633
34000000000002030005020302030000020200020100010001010100010301010301000000000034
33020002010200000205010001000200000502000003020004000100000203000101070003020033
33000100040201030000000001010000000103000000050500000101000100010100000000030233
34000001020103000000020100020101030000000000010000000001000000000300010000000033
33000101010300000200000102000103000101000400000100030100000100000202020001000233
33000000000000000000040300000000000003030001040000010000000100040100000001000234
33020201000503020002010000010104020000010300000500010001000002000100020100030134
34010000010000000202000000010001040000020000010301060000000000030300020001010033
34000201000100030000010200000201020201000000010202010001000000020100000001000033
33020201000202030201000101030004010301030301000000010201000100010100000001030034
34010000020103000001000002030004000000010201010000000004010006010002020100010034
34010200000000010102020606070000020000000002000003020200000100000101000201000233
33333333343333343333333333333433343433333434333334333434343334343434333333343333

image image:3
door @1,0 map:passage_w @1,19 0x0000
door @2,0 map:passage_w @2,19 0x0000
