34333334343333343333343433333434333333343334333334343433343334333433333334343434
34020200000103010100010301020000000400020000000300010000000000000000000100010034
33000300000100020003010005030702000200000002010002000000000202000101000101000433
34000101000004000000000101070000000000000100020001020001010001000002010401020133
34000001000002060003000003010101000002030000000003010001000102000101010001060033
33000000010001020201050003000701010000000202010001040100000100000202010000020034
34020301000000010000000401010402000000000002000000010400010002000102000100020033
33010200020000000002000100000002000101010001020000000100000000020001000204030233
33030001000401010004010000000100010001020003010700010003010202000201010202040034
33010000030102000002000100000000010000060001010003000000000000000203000100010034
34010000050101000000000200000000000401010104030101000100000000010000000100030134
33030003000200020300000000000000040003010000000002020001070000000001050100000234
33000001000000000100050101010300000001030100000001060000000102000000000300020134
34010005000100000303000201000003030000000100030000000101000001010001000003000034
34000000000000000001010000020100000301000202000100020000010000000201010201030333
33000000000200000004010100030000030001000003030102020000000103010202000400000034
34000004030301000200010000010001020000000200000000000004000100000100000100010234
34010101000001000100010000040100020000020100020005050000010303000004010000021012
34010000000201000002000001070300010003010100000101000301070202000001010300002022
34020100000003000000010003000001000103030102010000000001000000000000030000013032
33010000030002010002000301030000000200000100030003010100000100000000010100000133
34000201010200000100020102020101010002000001020000000100010000000000000200060233
33010200000000050104010101000001000200000000000200020201020200000002000100000033
33030100030100000203000000010401000201000100040001000203010001000005050200010034
34000100000000000204000000000100000303010101000002000200010001000204030102040634
33010001040201000000000104020600000101010003000000050003010000000101000502000234
34000001000100020004000103010002000003000000000100010201000000020000020402000033
33030000010000000202010002000003000300000200000102000001010100000100000002000033
33000101000000000101000003020000010400000500010000000100010202010203030000010434
34010403000102010101020001000100010000010201000101000103010201000004020701010034
34030401030101000001020001010005040000010200020000000001020000000001000300020033
34000003000101010100010002020001000003010200020100040000000102050002000003000034
33050000050100030600030002020002000101040203010302000000000001000101010500010334
34030002000101000003000203000103020001020302000100000000000203000100030201010033
34000000000200000000010000010500000000050101040001000002030000020200000202000033
33000001000200010000000000010000000000000200010102020005000000000000000000000034
33000001070100020002010002010000000101010100020000000601000700000002010000010034
33030000000403020100010000000102000201000002030200010000000000000203010300010034
34000100010000000102010101020001000000000201010100010103010403000500020100010033
34333434330000333434333433333434343433333334333434333434333333343334343434333333

image image:3
door @5,39 map:passage_w @5,0 0x0000
door @6,39 map:passage_w @6,0 0x0000
