40414141414141414141414141414141414141414141414141414141414141414141414141414142
50436161616161616161616161616161616161616161616161616161616161616161616161614452
50520503010300000004000001000100010100020001000500000000010100000200010100005052
50520000010101050001000000000101020100000100040601010100000201020100010203015052
50520000000001000001010100000000020101010000030000000100010000010003010000015052
50520400070400000000010200000503020101000000000302000101000001000002000102005052
50520000000100000301030000040004010100000001000003000101050000000000000000005052
50520300020102010001000501020200000103000005000201000000000001000102010302015052
50520204020000050000000201000102020101000000000100010000020000010006000100015052
50520001000200000002030101000001000203020001000000010300000100010100010000025052
50520100020000010300000101010005010101000501000300010100000300000101000201015052
50520600000100030000020100000003010401000100010201020101030001010001000102005052
50520000030001010200020100000000010000000101040100000100000004010000000001005052
50520202020000010101020004010100000101030102000101040301000000020000010001015052
50520000000002040003010100020005000105030001010001010106010100010001030001015052
50520201000001040000020100000000000000000104000601020101000001000002040100055052
50520102030000000000030301010600000000000100010002020002020000000203010000005052
50520002000000000000000100020000000001000002010100000002030200010001010001015052
50520001000001010000000000000002010200020100010006040000000200020100020000035052
50520000010201000100000100040003010000000000010301020000000700010101000000015052
50520101000001020101000001000301000101000103030000000002020100020102020200035052
50520201010200020000000000030100010102000100050004000003010303010003010001005052
50520000030000000300020000010100000201000000030500010001000400000200000100015052
50520200000102000001000000010103000102000103000001010100000000010000000001015052
50520301000000000000030100000002010000020000000100010301010201000203010200005052
50520002010100000101000000010002010001000000010001000006020000000000000002005052
50520002010001000001000100010000000100000006020000010102020201010300010000015052
50520001000000000000010000000003010000000204000002030000000001050101010301015052
50534141414141414141414141414141414142014041414141414141414141414141414141415452
60616161616161616161616161616161616162026061616161616161616161616161616161616162

image image:3
door @19,29 map:village @12,14 0x0000
trappable (u8:item)cow 10
