1011111111111111111111111111111111111112
3031313131313131313131313131313131313132
3302000303010001010002020000000001010333
3302000000000000000000000000000000000034
0000000000000000000000000000000000000003
0701000000000000000000000000000000000002
0205000000000000000000000000000000000234
3401000000000000000000000000000000000133
3400000000000000000000000000000000000033
3301000000000000000000000000000000000034
3300000000000000000100000200000000000134
3300000000010200020034333334330200000134
3400003334333333333300000100000000000434
3302013300040034010100010001000000000034
3303033434343402333433343300000000000233
3404030103000002000100000033330300000134
3400000000000000000000000001000100000033
3403000000000000000000000000000000000033
3301000000000000000000000000000000000034
3402000000000000000000000000000000000033
3401010002010100000000000000000000000233
3300003433333401000000000000000000000133
3302343300000202000000000000000000010034
3333040002000000000000000000010100343433
3301000000000000000004030000003434340034
3400000000000000000001343434330007000233
3400000000000000000034340000000000000034
3404000001000000000100000300000000000234
3401023300000000000000000000000000000033
3303023403000000000000000000000000000034
3401000033000300040001000000000000000333
3302000034330205013333333433330000000034
3401000001343302343403010100343301000233
3401000000043334030102000001043301000433
3400000000000600010000000000333300000034
3402000000000000000000000000330000000234
3301000000000000000000000000000000000134
3401000002000200000506010003000100030133
1011111111111111120200101111111111111112
3031313131313131320102303131313131313132

image image:3
door @9,39 map:village @18,0 0x0000
door @10,39 map:village @19,0 0x0000
door @0,4 map:6 @39,4 0x0000
door @0,5 map:6 @39,5 0x0000
door @0,6 map:6 @39,6 0x0000
door @19,4 map:7 @0,4 0x0000
door @19,5 map:7 @0,5 0x0000
