2121212121212121212121212121212121212121
2121211331313131313131313131311421212121
2113313202020100000002010200003031142121
3132000101000200030100030001010002303131
0101010002000000010202010200010101000101
0200020510111112010104000000010000010105
0100001024211332010002010102000202101111
1111112413313204000000010000000402301421
2121133132020007010103000004010104012021
2113320201000001000200000210120003002021
1332010100040110111200000020231200002021
2200000100101124212311111124212204002021
2203021011242121212121212113313200022021
2200012021211331142121212122010100012021
2202033031313202303114212123120301102421
2203000401010000040630311421220100301421
2311120002000002000001003031320300023014
2121231112000001340000030100000100020020
2121212123120101000001020100030000001024
2121212121231200020101003400010402102421
2121212121212201000001000302020110242121
2121211331313205003400000210111124212121
2113313200000401020102001024212121212121
2122010200000003000110112421212121212121
1332000100340101010220212113313131142121
2202000001000001010020133132000001301421
2200030102000100020230320200040000003014
2201000010111201010103000000013300000220
2203001024212200000004000401000003000120
2200003014212311111111111111120000020220
2201010420212121212121212121231112000120
2200000030142121211331313131142123120220
2200000003301413313200010000301421220020
2312000201003032000103000103002021220120
2123120202000101000000000101102413320120
2121231111120004000001340500303132010020
2121212121231112000000000100010000030220
2121212121212123120001000001020000010020
2121212121212121220000101111111111111124
2121212121212121220202202121212121212121

image image:3
door @9,39 map:village @18,0 0x0000
door @10,39 map:village @19,0 0x0000
door @0,4 map:6 @39,4 0x0000
door @0,5 map:6 @39,5 0x0000
door @0,6 map:6 @39,6 0x0000
door @19,4 map:7 @0,4 0x0000
door @19,5 map:7 @0,5 0x0000
