21212121212121212121212121212121212121212121212121212121212121212201002021212121
21212121212121212121212113313131313114212121212121212121212113313201002021212121
21212121212121212121133132000002030030142121212121212121211332000100022021212121
21212121212121211331320000000101010100301421212121211331313202010301102421212121
21212121212113313201010300000001000000013014212121133201010000030000202121212121
21212121133132000005000204010505330100040030313131320000010300000110242121212121
21212113320001000000330004000103000000000000000202000100000002011024212121212121
31313132000401020001000104330000000000030000000000010007000002012021212121212121
01000102000300020000000101010000000203010200000000000200010301003014212121212121
00040000000200020200000000000433010300001011120100010201000202000120212121212121
00010001010000030034000002000101010002102421231200000000000001000130311421212121
41414141414201010200000101000001010210242121212312000001000100000300003014212121
51515151515341420100010001000004001024212121212123120010111112010001000030142121
51515151515151534141420000000003102421212121212121231124212123120100000401202121
51515151515151515151534141414210242121212121212121212121212121231200010000301421
51515151515151515151515151515230142121212121212121212121212121212312010001003014
51515151515151515151515151515342301421212121212121212121212121212122010200000120
51515151515151515151515151515153422021212121212121212121212121212123111200010220
51515151515151515151515151515151522021212121212121212121212121212121212312000220
51515151515151515151515151515151522021212121212121212121212121212121212122000120

image image:3
door @0,8 map:village @39,17 0x0000
door @0,9 map:village @39,18 0x0000
door @0,10 map:village @39,19 0x0000
door @33,0 map:8 @33,39 0x0000
door @34,0 map:8 @34,39 0x0000
door @37,19 map:9 @37,0 0x0000
door @38,19 map:9 @38,0 0x0000
trappable (u8:item)rabbit 10
trappable (u8:item)quail 10
trappable (u8:item)deer 5
