34333334333334333333333334333433343434333333343434333334343333343300013334333333
34040001020000060003000002000701000000010000000000000402000100010000020004000133
34000000000000000000000000000000000000000000000000000000000000000000000000000033
34000000000000000000000000000000000000000000000000000000000000000000000000000434
33000000000000000000000000000000000000000000000000000000000000000000000000000034
33000000000000000000000000000000000000000000000000000000000000000000000000000333
34000000000000000000000000000000000000000000000000000000000000000000000000000134
34000000000000000000000000000000000000000000000000000000000000000000000000000134
01030000000000000000000000000000000000000000000000000000000000000000000000000134
00000000000000000000000000000000000000000000000000000000000000000000000000000134
00010000000000000000000000000000000000000000000000000000000000000000000000000033
33010000000000000000000000000000000000000000000000000000000000000000000000000034
33010000000000000000000000000000000000000000000000000000000000000000000000000334
34000000000000000000000000000000000000000000000000000000000000000000000000000334
33000000000000000000000000000000000000000000000000000000000000000000000000000033
33000000000000000000000000000000000000000000000000000000000000000000000000000133
34050000000000000000000000000000000000000000000000000000000000000000000000000234
34010000000000000000000000000000000000000000000000000000000000000000000000040234
34000002010001000204000003000001020003020201010002010004020000000103000000000133
34343433343334333433333333333333333434333334333334343334343334333333343433030233

image image:3
door @0,8 map:village @39,17 0x0000
door @0,9 map:village @39,18 0x0000
door @0,10 map:village @39,19 0x0000
door @33,0 map:8 @33,39 0x0000
door @34,0 map:8 @34,39 0x0000
door @37,19 map:9 @37,0 0x0000
door @38,19 map:9 @38,0 0x0000
