3334333434343433010034343334333434343434
3304010200000200000100000106000100000033
3400000000000000000000000000000000000434
3400000000000000000000000000000000000134
3302000000000000000000000000000000000234
3400000000000000000000000000000000000033
3301000000000000000000000000000000000233
3300000000000000000000000000000000000133
3401000000000000000000000000000000000134
3301000000000000000000000000000000000034
3401000000000000000000000000000000000134
3302000000000000000000000000000000000034
3300000000000000000000000000000000000133
3303000000000000000000000000000000000133
3401000000000000000000000000000000000034
3400000000000000000000000000000000000134
3301000000000000000000000000000000000033
3302000000000000000000000000000000000033
3304000000000000000000000000000000000134
3400000000000000000000000000000000000033
3405000000000000000000000000000000000133
3400000000000000000000000000000000000034
3300000000000000000000000000000000000033
3300000000000000000000000000000000000034
3400000000000000000000000000000000000133
3400000000000000000000000000000000000134
3402000000000000000000000000000000000034
3400000000000000000000000000000000000033
3300000000000000000000000000000000000033
3300000000000000000000000000000000000133
3402000000000000000000000000000000000034
3400000000000000000000000000000000000033
3302000000000000000000000000000000000234
3301000000000000000000000000000000000134
0200000000000000000000000000000000000634
0300000000000000000000000000000000000134
3300000000000000000000000000000000000004
3305000000000000000000000000000000000002
3300010103000000010000000001000003010034
3333333433333433333433343433333333333334

image image:3
door @8,0 map:village @13,39 0x0000
door @9,0 map:village @14,39 0x0000
door @19,36 map:10 @0,36 0x0000
door @19,37 map:10 @0,37 0x0000
door @0,34 map:11 @39,34 0x0000
door @0,35 map:11 @39,35 0x0000
