2121212121212122020150515151515151515151
2121212121212122010050515151515151515151
2121212121211332000150515151515151515151
2121212121212200000250515151515151515151
2121212121133200010150515151515151515151
2121211331320002000260445151515151515151
2121133201020100010500505151515151515151
2121220200020206020200505151515151515151
2121220102000000010103505151515151515151
2121220002020100000003604451515151515151
2121231202000001000000005051515151515151
2121212202000000010000015051515151515151
2121212312000102000003015051515151515151
2121212122000102010001005051515151515151
2121212122000000020103005051515151515151
2121133132000000000101006044515151515151
3131324041414200000100000150515151515151
4141415451515342000100010050515151515151
5151515151515153420101000450515151515151
5151515151515151520200000050515151515151
5151515151515151534203040060445151515151
5151515151515151515201010100505151515151
5151515151515151515342010000604451515151
5151515151515151515152000000005051515151
5151515151515151515152000000035051515151
5151515151515151514362000200065051515151
5151515151515151436201020000005051515151
5151515151515143620100000401405451515151
5151515151515152000100010000505151515151
5151515151514362010200000040545151515151
5151515151515202010000014054515151515151
5151515151515203010040415451515151515151
5151515143616203004054436161616144515151
6161616162060000006044520003000160445151
0101050000000133020050520134010500604451
0000000400030201000050520000050100026061
4141420003000000030050534142050100050101
5151534200000004004054515153420603000001
5151515341414141415451515151534141414141
5151515151515151515151515151515151515151

image image:3
door @8,0 map:village @13,39 0x0000
door @9,0 map:village @14,39 0x0000
door @19,36 map:10 @0,36 0x0000
door @19,37 map:10 @0,37 0x0000
door @0,34 map:11 @39,34 0x0000
door @0,35 map:11 @39,35 0x0000
