21212121220002202121212121212121212121212121212121212121212121212121212121212121
21212121220402301421212121212121212121212121212121212121212121212121212121212121
21212113320004012021212121212121212121212121133131313114212121212121212121212121
21212122000000052021212121212121212121211331320102050020212121212121212121212121
21212122010101013014212121212121212113313203010701000030142121212121212121212121
21211332000002020020212121212121133132010003030002330000202121212121212121212121
21212200040001030030142121212113320203010000010000000000301421212121211331311421
21212200000002010100301421212122000101023300020000010003002021212121212201013031
21212200000000010000012021211332000002070301000100000202003014212121133201000002
21133200000101000104003014133200010200010701001012010100000120212113320101000000
21220201000501000100000220220002030001000104022023120000340030141332000100020010
21220001020401000001010030320203003301020000102421220002010101303200013400041024
21220001050003030101000300030400010100010210242121231200000200000400000300102421
21220000000200000100040100000201000101011024212121212201020001010100030000202121
13320000010010111205000100020000000000102421212121212312000100023302000010242121
22020000001024212312001011120100010110242121212121212123120102010200001024212121
22000101102421212123112421231200011024212121212121212121231112000200102421212121
22000010242121212121212121212311112421212121212121212121212123111111242121212121
22020120212121212121212121212121212121212121212121212121212121212121212121212121
22000020212121212121212121212121212121212121212121212121212121212121212121212121

image image:3
door @39,8 map:village @0,26 0x0000
door @39,9 map:village @0,27 0x0000
door @1,19 map:12 @1,0 0x0000
door @2,19 map:12 @2,0 0x0000
door @5,0 map:13 @5,39 0x0000
door @6,0 map:13 @6,39 0x0000
trappable (u8:item)rabbit 10
trappable (u8:item)quail 10
trappable (u8:item)deer 5
forage
