33333434340000333433333433343434343434333333343434333333343433333334333434333433
34010202000103020001000001020102040402000001010003000002020001010002010001000133
33010000000000000000000000000000000000000000000000000000000000000000000000000034
33010000000000000000000000000000000000000000000000000000000000000000000000000033
33030000000000000000000000000000000000000000000000000000000000000000000000000033
34000000000000000000000000000000000000000000000000000000000000000000000000000033
33020000000000000000000000000000000000000000000000000000000000000000000000000034
33000000000000000000000000000000000000000000000000000000000000000000000000000134
34000000000000000000000000000000000000000000000000000000000000000000000000000200
34010000000000000000000000000000000000000000000000000000000000000000000000000000
34000000000000000000000000000000000000000000000000000000000000000000000000000133
33010000000000000000000000000000000000000000000000000000000000000000000000000034
33000000000000000000000000000000000000000000000000000000000000000000000000000333
33050000000000000000000000000000000000000000000000000000000000000000000000000033
34010000000000000000000000000000000000000000000000000000000000000000000000000034
34000000000000000000000000000000000000000000000000000000000000000000000000000033
33000000000000000000000000000000000000000000000000000000000000000000000000000134
33010000000000000000000000000000000000000000000000000000000000000000000000000034
34020400040002000002000200010003040100030101000200000001010000020401030100000034
33010033333433333333333333333334333434333334333334343334333333333334333433343334

image image:3
door @39,8 map:village @0,26 0x0000
door @39,9 map:village @0,27 0x0000
door @1,19 map:12 @1,0 0x0000
door @2,19 map:12 @2,0 0x0000
door @5,0 map:13 @5,39 0x0000
door @6,0 map:13 @6,39 0x0000
