33343434333433333333333434333333333334333333333434333334343334343433333434343433
34010102000300010200010300030000000100000101010103000101020002010100000301000133
33000100000102000200030001000100010000030200000000050002000102000201000002030033
33000000030000000400010102000003010400013303010104003307010100000102020100000434
33010100000000010000000001010206000001003400020001003301330200030101000003030100
33000100000400000101000101000401000002013402013434003433010303010301000000000100
34020100000100010102040000020002000204021012003301003302340100000000020101000302
33000000000000030100000000030001030000053032013404003401003300000003000000020233
33000102000001010004000001000102000205000303020404010100000004020000000000010234
34010104010201010102020001010003010102020001010201000102020402040100030000030134
33000001000001010102010005010100000001020001000200010000000002000000000302000034
34010002000101010004000002010000040001020000000001020001000001010000000002020133
34000001000301000104020101000300000204040100030000000000010000000101000000020133
34010001000100020001010000010100040001000003040202020002010101010000000000000034
34000002000002010102030200000400010000000000000100040100000100030200000101000134
34000400030101000002000100030201000500000101040201000104000002010103000001000233
34000300000001020200000001000201010000000000030000020101030200020100030000000133
34000000000100010200010001000000010001020200000500000101000003000001010101020434
33000001000001010002020001040304000000010200000003010001010202010002000000000034
34010001030000000002010401020400000000010000020004050100000100030000030206000234
33000202000200000200000601000000000101000101000000010100010100020403020300010034
34010003000101000002010203000000000200010001000005000000000300020000000000000033
34000100000305000100000000000200010003040300030003000500010001040700020005010234
33010002000001010000000000010206000100010000000404000001000100000003000100000233
34020200010000000002050201000000000406010002010000010400000100000200020201000033
34020000010000010000030200030002000100000000010100000000000000040300000000020033
34010106050002020101070204020000000007000700000000010001030000000000020300000133
33000001000200030000020000000202000002010000000000000100000200000000000200000234
34000201000000000300000001010100010201000405010201020100000401000000010104000233
34020001000401030000000001000001030100000101000300000101010202050200010002010133
34010401010102000102030001020003010000000100000000010000010200000201010003010033
34000200000105000000000000020103000000000000010100020000010300030100010000010234
33030400000003000600030000020101000000000200000101000000000000000200000400010233
34020100000000000001010001040000000000000003000300020001000000050600010100020034
33000400000500000202010200000002010100000001000101000001000002000000030400020133
33010100000001000000000301010000000000000100000001000201020000000002000200000033
34010000020003010100000101000100030000000002000100010100000000000002010000010034
34000202010000030100020001000000010201000001010004000104000101000100000003030033
34020000030301000101000000000403030000010000000000000001000100000201000003010034
33343333333433343434333434333333333333333333333433343433333433333334333433333334

image image:3
door @39,4 map:passage_n @0,4 0x0000
door @39,5 map:passage_n @0,5 0x0000
door @39,6 map:passage_n @0,6 0x0000
trappable (u8:item)rabbit 10
trappable (u8:item)rat 10
trappable (u8:item)quail 2
trappable (u8:item)deer 1
