33343333343333333434333434333333333434343333333434333433333334341011111233333433
34000001000100000200010000000200010000030102000002000102030105003031313201000533
34010104000101020100000101010303010300050000030100010100010300010000020000010034
33010000000000010200000201330000000000000100000000010000010001000101020001000034
06000100020034330200333301340000010600010200000000000003010000000101000000000234
00000101000033030001330001330000000200000502010003010205000301000000010002000034
33010101040433340033330002003301020000020001000100000302000101020101000001000233
34000004030000010000010003010400030202000001030301000002000101000000010101000033
34000001010103000200010002000001020101020000000201000200020100000505000003000033
33030000020001010200000002000302000000000006000001030002020200020000000000000033
33020000020600010000000600000103000202000003010101000100000102000100000002000333
33020000000001000101000100010000000303000100040000010001000500000000000002000033
33010000000000000200000101020102010001000000010001000201020000010200000200010033
33030302000101000101000003040100010200010102000001020500000102000300000102010233
33000201000001000007020003010003000000050001010001020301000100010100030006000234
34010100010002010101000101040102000104000200000201020301010000000000000100000133
33020003000200000000020003020000000103030301000101030000000200010001000100000033
34000101000000000000000000000001010200020201000101000203000100000000000204000033
34000200020201020200000000010502000302000301010104000000010100000000020000000034
33020001000003010500020400030600050001000000020203020001000001000400000000010634
33000000020001010403000100000100000100030300000000000100010100000000020202010034
34000300000600030000020000000102000204010002000002000103010102000101000202010033
34000001000000000101000100000100000100010000010100010201010000000000000000030033
33010100010000010100000003000201020302000000000000000000000100000200010107000033
34010001010001020203000000060002000001030002000201000304000100020001000402010134
33000200000300010001010200010001020000010000000000000006000000020301000006020334
33010100020002010001000404020403000000000101000300000000010101010001000002000233
34000000000100010205010301050002010303000002010001000000020001010100020006020034
33000000020004000101020102000301000001050302000100000103000000000001010103030034
33000200000003000000000101000201000100010301000001010000020102000100010002010033
33000105020100020201010101000103000102010001000102000001010000010001000000000033
33010005000000020200000300020100000003000000000000000001000101000400010102000134
34020203000100010000000000000400020001030000020100000000010200010000020000000033
34000100000004000001000305000300010700030100030000000100000000030300040300000334
10120302010100030001000003010000010103010001020000000100020002000000020202000033
20220301000100010206030400010000020200000100010001000401030002000001010000000234
20220001000100000000020000000000020200010000000000030100010001000202010601010033
30320002000100020100000100000106010002010001010002010001020100000001030000000034
34030000000300000507010000030001000001000000000000030300050004000104000200020233
33333333333433333434343333343334333433333433343333343334333434333434333434343334

image image:3
door @0,4 map:passage_n @19,4 0x0000
door @0,5 map:passage_n @19,5 0x0000
trappable (u8:item)rat 10
trappable (u8:item)rabbit 10
trappable (u8:item)quail 10
trappable (u8:item)deer 5
forage
