34333333343334343334343433333333333433333333343433343334333434343433333433343434
33010100000200000000000002000200000104000001000001020200000000010100010000040034
33000204020102010001010002000200000002000201000000020000030000000000000000010033
33060000020200030005010101000300000201000200020000000102000002000300010300010333
34000100000000010001040101000400000000000201000200000100000001000000000000000034
34010100020300010000010202010201000000010100000002030000010001020202000002010133
33010100000000020100000002000201030001000000000200010100000000000002050000040033
33020005000101020102010100020101000005000003000001030300000100000002000003020233
34000201020100000002000007010000020100000100000000000203020504030002010102010034
33030200010400010101000201040002010302010100000202000300000200000200000003020034
33030002000105020200000101000001010000000100000203000100000001030000020001020234
34020100000001000603030000010000000000030000010000010100000201000001000300000133
33000100020000010001020005000100000300010100010001000100000103010400010000030334
33000201030100070101020201000101020001010001010000000000020100030001010000020033
34000200000100000402000102010000040002040000030100000100040302000002010200000033
33000000010100040000010200000100010101000002000000000001000300000000000101020033
33030200000003010000040200000000000102030103000007000000000100000004000100010033
34040301010202000000010202000100000004000000000303000000010400000100000003000034
34010101000102010104020106020201000302010000020001030001000500010103000002020233
34000200030000000101020200030001030001030001010401020001000201040000000000030133
33000000020002030202000202010000000303000301010200000001000200020002020102010234
33000102000000010000000000000104010102010201010300040002060403000000000002000234
33030000000000030702010200010400000002000100020102030100010001000001000304010034
34050000000000000201010301030100000100020300000002000200000002000001010000010134
33010203020200010000000000000000000000010201020000020001010001030107020001000034
34050002020000000200020000000200010000000105000001010100020000000000010000000033
33010101020001020200030200000300000200010101010100010100010102020000020000010034
33000300000000000401010003000400000600000202000002000000010102040202000200000134
33030300000302020001000400010101010400000000000104000206000000050000020301000334
34000002030100010102000300000200010001000001030000000101030000010001030003000033
34000003010001000100000300000000010100000000000001010400000001010102020300000034
34000100030002000000000000020101000300000002000302010002010600000004000102000034
34010102010500020002010001030003020201000201000001000000000101070000000000010034
34010000000100000001050000000002000200030201000000000102010002000100000204010234
34000000010200000001010600000001000104010000010204010000020000030001010005010034
34020300000101000202010001000201000102000400010100000103010001020001010100010034
33000300000002020400000000010001000104010100000001010002020002020100010502000033
33040000030000000201000101000000020000020000000000000000000500060101010000000033
34010000000500000200010000010102020502010003010001010101010000010200050000020033
34333433343434343334343434343333333333333334343433343334343333333300003434333434

image image:3
door @33,39 map:passage_e @33,0 0x0000
door @34,39 map:passage_e @34,0 0x0000
trappable (u8:item)rat 20
trappable (u8:item)rabbit 10
trappable (u8:item)quail 10
forage
