34343333343334333334343333333434333334333333333434333334333433343333343334000134
33010200020100000000030400020003010200000301000202000000070101000202000001000134
34010102000000000101010202010500030000030000020001000100000103000003000001030234
33000001000001000101010301010301020000010000010200030000010000030000000001000134
34010100020000010400010400000103020301000200000202010002020401000000010200000034
34000002000001070000000001000200010000010000020000000000060200000301010104000134
34010003010101000103010003000200000101010301030100020002000000010101000001010133
33010004000000040100000001040000000001000101000401010301020402000000010300020233
33020400010001000300030100000000000001010103000101010000010000000001000200000633
33000000010004020401020100000200010201000300000001000300000000020201000201000033
33000001000102000100050200000002000004040000010102010000010000000005000000000033
34000200020502010202050302030000000001020002000100000200020103000001000201000533
34000000030201020302000000020001000101000305010004010001000101000001040102000034
33040302010002000001020003000100010001030300000200000100000203050000010303000034
34020200000300000004000101000000000401000100030000010001010000000205020000020234
33010102010001020300010000010000040203020000010101000000000102010001000101000433
33050501060501000101040000070000010000060001000400030001000001020002000502010033
33020000000000000000000002010000000101010401000000030001010100000001000000000034
33020000040301030300000004030000000000040100000000020000010002010501030300020133
33000100000400000200020004020501000503000100010200030100000000000101030000010034
34010400000100040300000001030101000100030002000701030002020502010202030001000234
33000001000302070001060100010003000000010400000000010003000104020200000601020034
34020100050000010100000004000000010300000000010001010000020002000002010101000233
33000103000000000201000000000301000004000001000300050102010000010100000001000034
33020000010104000200000201010201000000000001000100000200000500000200020200010033
34010001050000000300010000000001000001010000010200000000000300000000010302000034
34040000040000020000020100010104000001030101000100010101000000010004000000000033
33010100000300010100010100020400020101010000000001010201010202010100000102000034
33000000020002020100000101010104000000010200000103000100000000000005010000000034
34010100010000000002000001010000000000010003010103020000000000020001000100010034
34000100030000000203030000000001040301000000000100020200000001010000010003010134
33030001000401010100000101010200000000000100000001000000020601010102000000010034
33010002010201000000010000000200030000000000000001000300010201000100000001010033
33010301000300000001000003020001020006010400000003010001000400030003000101030033
33010000000002010100010300000101000100040002030200000101040000020200000000000033
33000003000002000101010300000001010100040100020001010002010505020001030100000033
34010000010101000400000400000207000000000002000100000100040002030003020104030133
34000101000000020002030202000100000100000000000100000300000004010001010102000133
33020000000102040002010200000000000000000001000200000100000107010501010100010033
33343433343433333433343333333434343433333433343433343434343434343434333434333334

image image:3
door @37,0 map:passage_e @37,19 0x0000
door @38,0 map:passage_e @38,19 0x0000
trappable (u8:item)rat 10
trappable (u8:item)rabbit 10
trappable (u8:item)quail 10
trappable (u8:item)deer 5
forage
sprite @35,5 sprite:item (u8:item)flashsauce 0x000000
